10 23 3 45 5 6 7 18 9 -10
1 2 3 4 5 6 7 8 9 2
1 2 3 4 5 6 7 8 9 2
1 2 3 4 5 6 7 8 9 2
1 2 3 4 5 6 7 8 9 2
1 2 3 4 5 6 7 8 9 2
1 2 3 4 5 6 7 8 9 2
1 2 3 4 5 6 7 8 9 2
-10 19 -3 0 6 7 8 9 2 4
